22 16
25 25
2 2 3 3 3 2 2 2 2 3 3 3 3 3 3 3 3 3 2 2 2 2
2 3 3 3 3 3 3 3 3 3 3 2 2 2 3 3 3 3 3 3 3 3
3 3 3 3 21 22 22 23 3 3 3 3 3 3 3 3 3 3 3 3 3 2
3 2 2 2 41 42 42 42 23 3 3 3 3 3 3 3 3 3 2 2 2 2
3 21 22 22 42 42 42 42 43 3 3 3 3 2 3 3 3 3 2 2 2 2
2 41 42 42 42 42 42 42 42 22 22 22 22 22 22 22 22 22 22 23 2 3
3 41 42 42 4 42 42 42 42 42 42 42 42 42 42 4 42 42 42 42 23 3
3 41 85 42 42 42 42 42 42 42 42 42 42 42 42 42 42 42 42 42 43 2
2 41 42 42 42 42 42 42 42 42 5 42 42 42 42 42 42 42 42 42 43 3
2 61 42 42 42 42 42 42 42 42 42 42 42 42 85 42 42 42 42 42 43 3
3 3 61 42 42 42 42 42 85 42 42 42 42 42 42 42 42 4 42 42 43 2
3 3 3 62 62 42 5 42 42 42 42 42 42 42 42 42 42 42 42 42 43 2
2 3 3 3 2 62 62 62 62 42 42 42 42 42 42 42 42 62 62 62 63 2
2 3 3 3 3 3 3 3 3 62 62 62 62 62 62 62 62 3 3 2 2 2
2 3 3 3 3 3 3 3 3 3 3 3 3 3 3 3 3 3 3 3 3 3
2 3 3 3 3 3 3 3 3 3 3 3 3 3 3 3 3 3 3 3 2 2
